000000000000000000000000000000000000000000000000000000000000000000000000000000000000000000000000000000000000000000000000000000
000000000000000000000000000000000000000000000001111111100000000000000000000000000000000000000000000000000000000000000000000000
111110000000000000000000000000000000000000000002222222200000000000000111000000000000000000000000000000000000111111111111100000
222220000000000000000000000000000000000000000000000000000000000000000222000000000000000000000000000000000000222222222222200000
333330000000000000000000000000000000000000000000000000000000000000000000000000000000000000000000000000000000000000000000000000
000000000000001110000000000000000000000001100000000000000000000000000000000000000000000000000000000000000000000000000000000000
000000000000002220000000000000000000000002200000000000000000000000000000000000010000000000000000000000000000100000000000000000
000000000000000000000000000000000000100000000000000000000000000000000000000000020000000000000000000000000000200000000000000000
000000000000000000000000000000000001200000000000000000000000000000000000000000020000000000000000000000000010000000000000000000
000000000000000000000000000000000002200000000000000000000000000000000000000000021000000000000000000000000020000000000000000000
000000000000000000000000000000000000000000000000000000000010100000000000000000022000000000000000000000001000000000000000000000
000000000000000000000000000000011000000000000000000000000021200000000000000000000000000000000000000000002000000000000000000000
000000000000000000000000000000022000000000000000000000000002000000000000000000000000000000000000000001000000000000000000000000
000010100000000000000001100000000000000000000000000000000000000000000000000000000000000000000000000002000000000000000000000000
000021211000000000000012111000000000000000000000000000000000000000000000000000000001000000010000001000000000000000000000000000
000022222200000000000022222000000000000000000000000000000000000000000000000000000000000000000000002000000000000000000000000000
000000000000000000000000000000000000000000000000000000000000000000000000000000000000000000000000000000022000000000000000000000
000000000000000000000000000000000000000000000000000000000000000000000000000000000000000000000000000000011000000000000000000000