0000000000000000000000000000000000000000000000000000000000000000
0000000000000000000000000000000000000000000000000000000000000000
0000000000000000000000000000000000000000000000000000000000000000
0000000000000000000000000000000000000000000000000000000000000000
0000000000000000000000000001111110000000000000000000000000000000
0000000000000000000000000000000000000022222222220000000000000000
0000000000000000000000000000000000000000000003333333333333000000
0000000000000000000000000000000000000000033333333333300000000000
0000000000000000000000000000000000000333333333333000000000000000
0000000000000000000000000000000003333333333330000000000000000000
0000000000000000000000000000033333333333000000000000000000000000
3333330000003333333333333000000000000000000000000000033333333333
3333333300000000000000000000000000000000000000000033333333333333
0333333333300000000000000000000000000000000000333333333333333330
0003333333333333300000000000000000000000003333333333333333330000
0000000333333333333333000000000000000333333333333333333333000000
0000000000000000000333333333333333333333333000000000000000000000
0000000000000000000000000000000000000000000000000000000000000000