0000000000000000000000000000000000000000000000000000000000000000
0000000000000000000000000000000000000000000000000000000000000000
0000000000000000000000000000000000222220000001111111100000000000
0001133332200000000000000000000000000000000000000000000000000000
0000000000000000000000000111110000000000000000000000000000000000
0000000000000000000000000000000000000000000000000000000000000000
0000000000222222200000000000000000000000000000000000000000000000
0000000000000000000000000000000000000000000000000000000000000000
0000000000000000000000333333333333000000011111111110000000000000
0000000131313330000000000000000000000000000000000000000000000000
0000000000000000000000000000000000000000000000000000000000000000
0000000000000000000000000000033333312200000000000000000000000000
0000000000000000000000000000000000000000000000000000002222200000
0000000003333333333333000000000000000000023232323232330000000000
0000000000000000000000000000000000000000000000000000000000000000
0000000000000000000000000000000000000000000000000000000000000000
0011111111000000000001111111111100000000000000111111111111111111
0000000000000000000000000000000000000000000000000000000000000000