0001310000000000000000000000000000000000000001310000000000000000
0003320000000000000000000000000000000000000000330000000000000000
0022332000000000000000000000000001333100000000000000000000000000
0000000000000000000000000000000000033000000000000000000000003310
0000000000000000000000000000000000020000000000000000000001133330
0000000000000000000000000000000000000000000000000000000022333300
3113331331000000000033133131100000000000000000031110000000033000
3322000000000000000000000023311000000000000000333222000000000000
2200000000000000000000000000222000001330000000222233000000000000
3300000000000311000000000000220000000230000000223333000000000000
2300001333300332100000000000320000000000000233333333000110000000
3300002222300000000000011000333300000000000000330000000230000000
3210000000000000000000332000333000000000000000000000000000000000
2200000000000000000000000000000000000000000000000000000000033100
3300000000000000033000000000000000000003100000000022000000023000
3200013330000000033331111000000013300003330000223322000000000000
2200022330000333333333322110001333200002330000233332200000000000
2200022220000333333333222220002222200000000000222222200000000000