000111000000000000000000000000000000000000000111000000000000000
000222000000000000000000000000000000000000000022000000000000000
002202200000000000000000000000000111110000000000000000000000000
000000000000000000000000000000000002200000000000000000000001110
000000000000000000000000000000000002000000000000000000000112220
000000000000000000000000000000000000000000000000000000002222200
111211111100000000001111111110000000000000000001110000000000000
222200000000000000000000002221100000000000000012222000000000000
220000000000000000000000000022200000111000000022222000000000000
220000000000011100000000000022000000022000000022222000000000000
220000111110022210000000000022000000000000022222222000110000000
220000222220000000000001100022220000000000000022000000220000000
221000000000000000000022200022200000000000000000000000000000000
220000000000000000000000000000000000000000000000000000000011100
220000000000000001100000000000000000000110000000022000000022200
220001111000000002211111100000001110000221000022222000000000000
220002222000022222222222211000112220000222000022222200000000000
220002222000022222222222222000222220000000000022222200000000000