000000000000000000000000000000000000000000000000000000000000000
000000000000000000000000000000000000000000000001111111100000000
111110000000000000000000000000000000000000000002222222200000000
222220000000000000000000000000000000000000000000000000000000000
333330000000000000000000000000000000000000000000000000000000000
000000000000000000000000000000000000000001100000000000000000000
000000000000000000000000000000000000000002200000000000000000000
000000000000000000000000000000000000000000000000000000000000000
000000000000000000000000000000000001100000000000000000000000000
000000000000000000000000000000000002200000000000000000000000000
000000000000000000000000000000000000000000000000000000000000000
000000000000000000000000000000011000000000000000000000000000000
000000000000000000000000000000022000000000000000000000000000000
000000000000000000000000000000000000000000000000000000000000000
000011111100000000000001111000000000000000000000000000000000000
000022222200000000000002222000000000000000000000000000000000000
000000000000000000000000000000000000000000000000000000000000011
000000000000000000000000000000000000000000000000000000000000022