000000000000000000000000000000000000000000000000000000000000000
000000000000000000000000000000000000000000000000000000000000000
000111000000000000000000000000000000000000000111000000000000000
000222000000000000000000000000000000000000000000000000000000000
000000000000000000000000000000000111110000000000000000000000000
000000000000000011111000000000000000000000000000000000000000000
000000000000000000000000000000010000000000000000000000000000000
000000000000000000000000000000000000000000000000000000000000000
111111111100000000000000000000000000000000000000000000000000000
220000000000000000000001111110000000000000000001000000000000000
220000000000000000000012222221000000011000000012000000000000111
220000000000011100000022200222000000022000000122100000000111222
220000111110022210000000000000000000000000000000000000000000000
220000222220000000000000000000000000000000000000000000000000000
220000000000000000000000000000000000000000000000000000000000000
220000000000000000000000000000000000000000000000000000000000000
220000000000000001100000000000000000000110000000000000001110000
220001111000000002211111111000111110000000000000000000012220000
220002222000022222222222222000222220000000001110000000122200000
220002222000022222222222222000222220000000002220000000000000000