0001110000000000000000000000000000000000000001110000000000000000
0002220000000000000000000000000000000000000000220000000000000000
0022022000000000000000000000000001111100000000000000000000000000
0000000000000000000000000000000000022000000000000000000000001110
0000000000000000000000000000000000020000000000000000000000112220
0000000000000000000000000000000000000000000000000000000002222200
1112111111000000000011111111100000000000000000011110000000000000
2222000000000000000000000022211000000000000000122222000000000000
2200000000000000000000000000222000001110000000222222000000000000
2200000000000111000000000000220000000220000000222222000000000000
2200001111100222100000000000220000000000000222222222000110000000
2200002222200000000000011000222200000000000000220000000220000000
2210000000000000000000222000222000000000000000000000000000000000
2200000000000000000000000000000000000000000000000000000000011100
2200000000000000011000000000000000000001100000000022000000022200
2200011110000000022111111000000011100002210000222222000000000000
2200022220000222222222222110001122200002220000222222200000000000
2200022220000222222222222220002222200000000000222222200000000000