0000000000000000000000000000000000000000000000000000000000000000
0000000000000000000000000000000000000000000000000000000000000000
0000000000000000000000000000000000000000000000000000000000000000
0000000000000000000000000000000000000000000000000222220000000000
0000000000000000000000000000000000000000000002222222220000000000
0000000000000000000000000000000000000000022222222200000000000000
0000000000000000000000000000000000011000000000000000000000000000
0000000000000000000222222222222220000000000000000000000000000000
0000000000000000000000000000000000000033333333333330000000000000
0000000000000000000000000000000000000000000000000000000333333333
0000333333333300000000000000000000000000000000000000011111111111
0000000000000000000000000000000000000000000000000111111111111111
0000000000000000000000000000000000333333333333000000000000000000
0000000000000001111111111111110000000000000000000000000000000000
0000000000000000000000000000000000000000000000000000000000000000
0333333333033333333000000033333333333333333333330000333333300000
0000000000000000000000000000000000000000000000000000000000000000
0001111111111000011111111110000011111111110000111111100001111111