111111111100000000
220000000000000000
220000000000000000
220000000000011100
220000111110022210
220000222220000000
220000000000000000
220000000000000000
220000000000000000
220001111000000000
220002222000011111
220002222000022222