000000000000000000000000000000000000000000000000000000000000000
000000011000000000000000000000000000000000000000000000000000000
111110022001100000000000110000000000000000000000000000000000000
222220000002200000000000220000000000000000000000000000000000000
333330000000000110000000000000000001111000000000000000000000000
000000000000000220000000000000000002222000000000000000000000000
000000000000000000000000000000000000000000000000000000000000000
000000000000000000110000000000000000000000000000000000000000000
000000000000000000220000000000000000000000000000000000000000000
000000000000000000000000000000000000000000000000000000000000000
000000000000000000000000000000000011100000000000000000000000000
000000000000000000000000000000000022200000000000000000000000000
000000000000000000000000000000000000000000000000000000000000000
000000000000000000000000000000000000000000000000000000000000000
000011110000000000000001111000000000000000000000000000000000000
000022220000000000000002222000000000000000110000000000000000000
000000000000000000000000000000000000000000220000000000000000011
000000000000000000000000000000000000000000000000000000000000022
